10 10 1 7 8 7
1 1 1 1 1 1 1 1 1 1
1 0 0 0 0 0 0 1 0 1
1 1 0 1 1 0 1 1 0 1
1 0 0 1 0 0 0 0 0 1
1 0 1 0 0 1 1 1 0 1
1 1 1 0 1 1 0 0 0 1
1 0 1 0 0 1 0 1 1 1
1 0 0 0 1 1 0 1 5 1
1 0 1 0 0 1 0 0 0 1
1 1 1 1 1 1 1 1 1 1